111111111111111111111111111111111111111111111111
1P0000000000000C0000000000000000000000C000000001
10000000000000C0000000000000000000000C0000000001
1000000000000C0000000000000000000000C00000000001
100000000000C0000000000000000000000C000000000001
10000000000C0000000000000000000000C0000000000001
1000000000C0000000000000000000000C00000000000001
100000000C0000000000000000000000C000000000000001
10000000C0000000000000000000000C0000000000000001
1000000C0000000000000000000000C00000000000000001
100000C0000000000000000000000C000000000000000001
10000C0000000000C00000000000C00000000000C0000001
1000C00000000000C0000000000C000000000000C0000001
100C000000000000C000000000C0000000000000C0000001
10CCCCCCCCCCCCCCCCCCCCC00CCCCCCCCCCCCCCCCCCCCC01
1000000000000000C00000000000000000000000C0000001
1000000000000000C00000000000000000000000C0000001
1000000000000000C00000000000000000000000C0000001
100000000000000000000000000000000000000000000001
100000000000000000000000000000000000000000000001
100000000000000000000000000000000000000000000001
1000000000000000000000000000000000000000000000E1
111111111111111111111111111111111111111111111111
